#...#...#.
#.#.#.#.#.
#.#.#.#.#.
#.#.#.#.#.
#.#.#.#.#.
#.#.#.#.#.
#.#.#.#.#.
#.#.#.#.#.
@.#...#...